11 11 13 13 13 13 13 13 13 13 13 13 13 13 13 13 13 13 13 13 13 13 13 13 13 13
13 11 11 11 11 12 13 13 11 11 11 11 13 13 13 13 13 13 11 11 11 11 11 13 13 13
13 11 11 11 11 11 11 64 11 11 11 11 11 11 13 13 13 11 11 11 11 11 11 13 13 13
13 11 64 11 11 11 11 11 11 12 11 11 65 11 13 11 11 11 11 11 64 11 11 11 13 13
13 11 11 65 11 64 11 11 11 11 11 11 11 11 11 11 64 11 11 11 11 11 11 11 11 13
13 13 11 11 11 11 11 11 11 11 11 11 11 11 11 11 11 11 11 11 12 11 11 11 11 13
13 13 11 12 11 03 00 00 00 00 00 00 03 64 11 12 11 11 11 11 11 11 11 11 11 13
13 11 11 11 11 01 08 08 08 55 08 08 01 11 11 11 11 11 11 11 11 11 11 11 11 13
13 11 11 11 11 01 08 08 08 08 08 08 01 11 11 11 11 11 11 11 11 65 11 11 13 13
13 64 11 11 11 01 08 08 08 08 08 08 01 11 65 11 11 11 64 11 11 11 11 11 13 13
13 13 11 11 11 01 08 08 08 08 08 08 01 11 11 11 11 11 11 11 11 11 11 11 11 13
13 13 11 11 65 01 08 08 08 08 08 08 01 11 11 11 11 11 11 11 11 11 11 11 11 13
13 13 11 11 11 02 08 00 00 08 00 02 02 11 11 11 12 11 11 11 11 11 11 11 11 13
13 12 11 11 11 11 11 11 11 64 11 11 11 11 11 11 11 11 11 64 11 11 11 11 11 13
13 11 11 64 11 11 11 11 11 11 11 11 11 65 11 11 11 11 11 11 11 11 11 11 11 13
13 11 11 11 11 11 11 11 11 11 11 11 11 11 11 11 11 11 11 11 11 11 11 12 11 13
13 13 11 11 11 11 11 11 12 11 11 11 11 11 11 64 11 11 11 11 11 64 11 11 11 13
13 13 13 13 11 11 11 11 11 11 11 13 13 13 13 11 11 11 11 11 11 11 11 11 13 13
13 13 13 13 13 13 13 13 13 13 13 13 13 13 13 13 13 13 13 13 13 13 13 13 13 13

-1 -1 -1 -1 -1 -1 -1 -1 -1 -1 -1 -1 -1 -1 -1 -1 -1 -1 -1 -1 -1 -1 -1 -1 -1 -1
-1 -1 -1 -1 -1 -1 -1 -1 -1 -1 -1 -1 -1 -1 -1 -1 -1 -1 -1 -1 -1 -1 -1 -1 -1 -1
-1 -1 -1 -1 -1 -1 -1 -1 -1 -1 -1 -1 -1 -1 -1 -1 -1 -1 -1 -1 -1 -1 -1 -1 -1 -1
-1 -1 -1 -1 -1 -1 -1 -1 -1 -1 -1 -1 -1 -1 -1 -1 -1 -1 -1 -1 -1 -1 -1 -1 -1 -1
-1 -1 -1 -1 31 -1 -1 -1 -1 -1 -1 -1 -1 -1 -1 -1 -1 -1 -1 -1 -1 -1 -1 -1 -1 -1
-1 -1 -1 -1 -1 -1 -1 -1 -1 -1 -1 -1 -1 -1 -1 -1 -1 -1 -1 -1 -1 -1 -1 -1 -1 -1
-1 -1 -1 -1 -1 -1 -1 -1 -1 -1 -1 45 -1 -1 -1 -1 -1 -1 -1 -1 -1 -1 -1 -1 -1 -1
-1 -1 38 -1 -1 -1 -1 -1 -1 -1 -1 54 -1 -1 -1 -1 -1 -1 -1 -1 -1 -1 -1 -1 -1 -1
-1 -1 -1 -1 -1 -1 -1 91 -1 -1 -1 -1 -1 -1 -1 -1 -1 -1 -1 -1 -1 -1 -1 -1 -1 -1
-1 -1 -1 -1 -1 -1 -1 99 -1 -1 -1 -1 -1 -1 -1 -1 -1 -1 -1 -1 -1 -1 -1 -1 -1 -1
-1 -1 -1 -1 -1 -1 -1 -1 -1 -1 39 -1 -1 -1 -1 -1 -1 -1 47 -1 -1 -1 -1 -1 -1 -1
-1 -1 -1 -1 -1 -1 -1 -1 -1 -1 -1 -1 -1 -1 -1 -1 -1 -1 -1 -1 -1 -1 -1 -1 -1 -1
-1 -1 -1 -1 -1 -1 -1 -1 -1 48 -1 -1 -1 -1 -1 -1 -1 -1 -1 -1 -1 -1 -1 -1 -1 -1
-1 -1 -1 -1 -1 -1 -1 -1 -1 -1 -1 -1 -1 -1 -1 38 -1 -1 -1 -1 -1 -1 -1 -1 -1 -1
-1 -1 -1 -1 -1 -1 -1 -1 -1 -1 -1 -1 -1 -1 -1 -1 -1 -1 -1 -1 -1 -1 -1 -1 -1 -1
-1 -1 -1 -1 -1 -1 -1 -1 -1 -1 -1 -1 -1 -1 -1 -1 -1 -1 -1 -1 -1 -1 -1 -1 -1 -1
-1 -1 -1 -1 -1 -1 38 -1 -1 -1 -1 -1 -1 -1 -1 -1 -1 -1 -1 -1 -1 -1 -1 -1 -1 -1
-1 -1 -1 -1 -1 -1 -1 -1 -1 -1 -1 -1 -1 -1 -1 -1 -1 -1 -1 -1 -1 -1 -1 -1 -1 -1
-1 -1 -1 -1 -1 -1 -1 -1 -1 -1 -1 -1 -1 -1 -1 -1 -1 -1 -1 -1 -1 -1 -1 -1 -1 -1
