{
    "tilesheets": [
        {
            "name": "default"
        }
    ],
    "layers": [
        [
            ["0:243", "0:243", "0:243", "0:243", "0:243", "0:243", "0:243", "0:243", "0:243", "0:243", "0:243", "0:243", "0:243", "0:243", "0:243", "0:243", "0:243", "0:243", "0:243", "0:243"],
            ["0:243", "0:243", "0:243", "0:243", "0:243", "0:243", "0:243", "0:243", "0:243", "0:243", "0:243", "0:243", "0:243", "0:243", "0:243", "0:243", "0:243", "0:243", "0:243", "0:243"],
            ["0:243", "0:243", "0:243", "0:243", "0:243", "0:243", "0:243", "0:243", "0:243", "0:243", "0:243", "0:243", "0:243", "0:243", "0:243", "0:243", "0:243", "0:243", "0:243", "0:243"],
            ["0:243", "0:243", "0:243", "0:243", "0:243", "0:243", "0:243", "0:243", "0:243", "0:243", "0:243", "0:243", "0:243", "0:243", "0:243", "0:243", "0:243", "0:243", "0:243", "0:243"],
            ["0:243", "0:243", "0:243", "0:243", "0:243", "0:243", "0:243", "0:243", "0:243", "0:243", "0:243", "0:243", "0:243", "0:243", "0:243", "0:243", "0:243", "0:243", "0:243", "0:243"],
            ["0:243", "0:243", "0:243", "0:243", "0:243", "0:243", "0:243", "0:243", "0:243", "0:243", "0:243", "0:243", "0:243", "0:243", "0:243", "0:243", "0:243", "0:243", "0:243", "0:243"],
            ["0:243", "0:243", "0:243", "0:243", "0:243", "0:243", "0:243", "0:243", "0:243", "0:243", "0:243", "0:243", "0:243", "0:243", "0:243", "0:243", "0:243", "0:243", "0:243", "0:243"],
            ["0:243", "0:243", "0:243", "0:243", "0:243", "0:243", "0:243", "0:243", "0:243", "0:243", "0:243", "0:243", "0:243", "0:243", "0:243", "0:243", "0:243", "0:243", "0:243", "0:243"],
            ["0:243", "0:243", "0:243", "0:243", "0:243", "0:243", "0:243", "0:243", "0:243", "0:243", "0:243", "0:243", "0:243", "0:243", "0:243", "0:243", "0:243", "0:243", "0:243", "0:243"],
            ["0:243", "0:243", "0:243", "0:243", "0:243", "0:243", "0:243", "0:243", "0:243", "0:243", "0:243", "0:243", "0:243", "0:243", "0:243", "0:243", "0:243", "0:243", "0:243", "0:243"],
            ["0:243", "0:243", "0:243", "0:243", "0:243", "0:243", "0:243", "0:243", "0:243", "0:243", "0:243", "0:243", "0:243", "0:243", "0:243", "0:243", "0:243", "0:243", "0:243", "0:243"],
            ["0:243", "0:243", "0:243", "0:243", "0:243", "0:243", "0:243", "0:243", "0:243", "0:243", "0:243", "0:243", "0:243", "0:243", "0:243", "0:243", "0:243", "0:243", "0:243", "0:243"],
            ["0:243", "0:243", "0:243", "0:243", "0:243", "0:243", "0:243", "0:243", "0:243", "0:243", "0:243", "0:243", "0:243", "0:243", "0:243", "0:243", "0:243", "0:243", "0:243", "0:243"],
            ["0:243", "0:243", "0:243", "0:243", "0:243", "0:243", "0:243", "0:243", "0:243", "0:243", "0:243", "0:243", "0:243", "0:243", "0:243", "0:243", "0:243", "0:243", "0:243", "0:243"],
            ["0:243", "0:243", "0:243", "0:243", "0:243", "0:243", "0:243", "0:243", "0:243", "0:243", "0:243", "0:243", "0:243", "0:243", "0:243", "0:243", "0:243", "0:243", "0:243", "0:243"],
            ["0:243", "0:243", "0:243", "0:243", "0:243", "0:243", "0:243", "0:243", "0:243", "0:243", "0:243", "0:243", "0:243", "0:243", "0:243", "0:243", "0:243", "0:243", "0:243", "0:243"],
            ["0:243", "0:243", "0:243", "0:243", "0:243", "0:243", "0:243", "0:243", "0:243", "0:243", "0:243", "0:243", "0:243", "0:243", "0:243", "0:243", "0:243", "0:243", "0:243", "0:243"],
            ["0:243", "0:243", "0:243", "0:243", "0:243", "0:243", "0:243", "0:243", "0:243", "0:243", "0:243", "0:243", "0:243", "0:243", "0:243", "0:243", "0:243", "0:243", "0:243", "0:243"],
            ["0:243", "0:243", "0:243", "0:243", "0:243", "0:243", "0:243", "0:243", "0:243", "0:243", "0:243", "0:243", "0:243", "0:243", "0:243", "0:243", "0:243", "0:243", "0:243", "0:243"],
            ["0:243", "0:243", "0:243", "0:243", "0:243", "0:243", "0:243", "0:243", "0:243", "0:243", "0:243", "0:243", "0:243", "0:243", "0:243", "0:243", "0:243", "0:243", "0:243", "0:243"]
        ],
        [
            [    "-1",    "-1",    "-1",    "-1",    "-1",    "-1",    "-1",    "-1",    "-1",    "-1",   "-1",    "-1",    "-1",    "-1",    "-1",    "-1",    "-1",    "-1",    "-1",    "-1"],
            [    "-1",    "-1",    "-1",    "-1",    "-1",    "-1",    "-1",    "-1",    "-1",    "-1",   "-1",    "-1",    "-1",    "-1",    "-1",    "-1",    "-1",    "-1",    "-1",    "-1"],
            [    "-1",    "-1", "0:176", "0:177", "0:178", "0:178", "0:178", "0:178", "0:183", "0:184",   "-1",    "-1",    "-1",    "-1",    "-1",    "-1",    "-1",    "-1",    "-1",    "-1"],
            [    "-1",    "-1", "0:201", "0:202", "0:203", "0:204", "0:206", "0:207", "0:208", "0:209",   "-1",    "-1",    "-1",    "-1",    "-1",    "-1",    "-1",    "-1",    "-1",    "-1"],
            [    "-1",    "-1", "0:226", "0:255", "0:255", "0:255", "0:255", "0:255", "0:255", "0:234",   "-1",    "-1",    "-1",    "-1",    "-1",    "-1",    "-1",    "-1",    "-1",    "-1"],
            [    "-1",    "-1", "0:226", "0:255", "0:255", "0:255", "0:255", "0:255", "0:255", "0:234",   "-1",    "-1",    "-1",    "-1",    "-1",    "-1",    "-1",    "-1",    "-1",    "-1"],
            [    "-1",    "-1", "0:226", "0:255", "0:255", "0:255", "0:255", "0:255", "0:255", "0:234",   "-1",    "-1",    "-1",    "-1",    "-1",    "-1",    "-1",    "-1",    "-1",    "-1"],
            [    "-1",    "-1", "0:226", "0:255", "0:255", "0:255", "0:255", "0:255", "0:255", "0:234",   "-1",    "-1",    "-1",    "-1",    "-1",    "-1",    "-1",    "-1",    "-1",    "-1"],
            [    "-1",    "-1", "0:251", "0:254", "0:255", "0:255", "0:255", "0:255", "0:256", "0:259",   "-1",    "-1",    "-1",    "-1",    "-1",    "-1",    "-1",    "-1",    "-1",    "-1"],
            [    "-1",    "-1", "0:276", "0:279", "0:280", "0:280", "0:280", "0:280", "0:281", "0:284",   "-1",    "-1",    "-1",    "-1",    "-1",    "-1",    "-1",    "-1",    "-1",    "-1"],
            [    "-1",    "-1",    "-1",    "-1",    "-1",    "-1",    "-1",    "-1",    "-1",    "-1",   "-1",    "-1",    "-1",    "-1",    "-1",    "-1",    "-1",    "-1",    "-1",    "-1"],
            [    "-1",    "-1",    "-1",    "-1",    "-1",    "-1",    "-1",    "-1",    "-1",    "-1",   "-1",    "-1",    "-1",    "-1",    "-1",    "-1",    "-1",    "-1",    "-1",    "-1"],
            [    "-1",    "-1",    "-1",    "-1",    "-1",    "-1",    "-1",    "-1",    "-1",    "-1",   "-1",    "-1",    "-1",    "-1",    "-1",    "-1",    "-1",    "-1",    "-1",    "-1"],
            [    "-1",    "-1",    "-1",    "-1",    "-1",    "-1",    "-1",    "-1",    "-1",    "-1",   "-1",    "-1",    "-1",    "-1",    "-1",    "-1",    "-1",    "-1",    "-1",    "-1"],
            [    "-1",    "-1",    "-1",    "-1",    "-1",    "-1",    "-1",    "-1",    "-1",    "-1",   "-1",    "-1",    "-1",    "-1",    "-1",    "-1",    "-1",    "-1",    "-1",    "-1"],
            [    "-1",    "-1",    "-1",    "-1",    "-1",    "-1",    "-1",    "-1",    "-1",    "-1",   "-1",    "-1",    "-1",    "-1",    "-1",    "-1",    "-1",    "-1",    "-1",    "-1"],
            [    "-1",    "-1",    "-1",    "-1",    "-1",    "-1",    "-1",    "-1",    "-1",    "-1",   "-1",    "-1",    "-1",    "-1",    "-1",    "-1",    "-1",    "-1",    "-1",    "-1"],
            [    "-1",    "-1",    "-1",    "-1",    "-1",    "-1",    "-1",    "-1",    "-1",    "-1",   "-1",    "-1",    "-1",    "-1",    "-1",    "-1",    "-1",    "-1",    "-1",    "-1"],
            [    "-1",    "-1",    "-1",    "-1",    "-1",    "-1",    "-1",    "-1",    "-1",    "-1",   "-1",    "-1",    "-1",    "-1",    "-1",    "-1",    "-1",    "-1",    "-1",    "-1"],
            [    "-1",    "-1",    "-1",    "-1",    "-1",    "-1",    "-1",    "-1",    "-1",    "-1",   "-1",    "-1",    "-1",    "-1",    "-1",    "-1",    "-1",    "-1",    "-1",    "-1"]
        ],
        [
            [    "-1",    "-1",    "-1",    "-1",    "-1",    "-1",    "-1",    "-1",    "-1",    "-1",   "-1",    "-1",    "-1",    "-1",    "-1",    "-1",    "-1",    "-1",    "-1",    "-1"],
            [    "-1",    "-1",    "-1",    "-1",    "-1",    "-1",    "-1",    "-1",    "-1",    "-1",   "-1",    "-1",    "-1",    "-1",    "-1",    "-1",    "-1",    "-1",    "-1",    "-1"],
            [    "-1",    "-1",    "-1",    "-1",    "-1",    "-1",    "-1",    "-1",    "-1",    "-1",   "-1",    "-1",    "-1",    "-1",    "-1",    "-1",    "-1",    "-1",    "-1",    "-1"],
            [    "-1",    "-1",    "-1",    "-1",    "-1",    "-1",    "-1",    "-1",    "-1",    "-1",   "-1",    "-1",    "-1",    "-1",    "-1",    "-1",    "-1",    "-1",    "-1",    "-1"],
            [    "-1",    "-1",    "-1",    "-1", "0:305",    "-1",    "-1",    "-1",    "-1",    "-1",   "-1",    "-1",    "-1",    "-1",    "-1",    "-1",    "-1",    "-1",    "-1",    "-1"],
            [    "-1",    "-1",    "-1",    "-1",    "-1",    "-1",    "-1",    "-1",    "-1",    "-1",   "-1",    "-1",    "-1",    "-1",    "-1",    "-1",    "-1",    "-1",    "-1",    "-1"],
            [    "-1",    "-1",    "-1",    "-1",    "-1",    "-1",    "-1",    "-1",    "-1",    "-1",   "-1",    "-1",    "-1",    "-1",    "-1",    "-1",    "-1",    "-1",    "-1",    "-1"],
            [    "-1",    "-1",    "-1",    "-1",    "-1",    "-1",    "-1",    "-1",    "-1",    "-1",   "-1",    "-1",    "-1",    "-1",    "-1",    "-1",    "-1",    "-1",    "-1",    "-1"],
            [    "-1",    "-1",    "-1",    "-1",    "-1",    "-1",    "-1",    "-1",    "-1",    "-1",   "-1",    "-1",    "-1",    "-1",    "-1",    "-1",    "-1",    "-1",    "-1",    "-1"],
            [    "-1",    "-1",    "-1", "0:186",    "-1",    "-1",    "-1",    "-1",    "-1",    "-1",   "-1",    "-1",    "-1",    "-1",    "-1",    "-1",    "-1",    "-1",    "-1",    "-1"],
            [    "-1",    "-1",    "-1", "0:211",    "-1",    "-1",    "-1",    "-1",    "-1",    "-1",   "-1",    "-1",    "-1",    "-1",    "-1",    "-1",    "-1",    "-1",    "-1",    "-1"],
            [    "-1",    "-1",    "-1",    "-1",    "-1",    "-1",    "-1",    "-1",    "-1",    "-1",   "-1",    "-1",    "-1",    "-1",    "-1",    "-1",    "-1",    "-1",    "-1",    "-1"],
            [    "-1",    "-1",    "-1",    "-1",    "-1",    "-1",    "-1",    "-1",    "-1",    "-1",   "-1",    "-1",    "-1",    "-1",    "-1",    "-1",    "-1",    "-1",    "-1",    "-1"],
            [    "-1",    "-1",    "-1",    "-1",    "-1",    "-1",    "-1",    "-1",    "-1",    "-1",   "-1",    "-1",    "-1",    "-1",    "-1",    "-1",    "-1",    "-1",    "-1",    "-1"],
            [    "-1",    "-1",    "-1",    "-1",    "-1",    "-1",    "-1",    "-1",    "-1",    "-1",   "-1",    "-1",    "-1",    "-1",    "-1",    "-1",    "-1",    "-1",    "-1",    "-1"],
            [    "-1",    "-1",    "-1",    "-1",    "-1",    "-1",    "-1",    "-1",    "-1",    "-1",   "-1",    "-1",    "-1",    "-1",    "-1",    "-1",    "-1",    "-1",    "-1",    "-1"],
            [    "-1",    "-1",    "-1",    "-1",    "-1",    "-1",    "-1",    "-1",    "-1",    "-1",   "-1",    "-1",    "-1",    "-1",    "-1",    "-1",    "-1",    "-1",    "-1",    "-1"],
            [    "-1",    "-1",    "-1",    "-1",    "-1",    "-1",    "-1",    "-1",    "-1",    "-1",   "-1",    "-1",    "-1",    "-1",    "-1",    "-1",    "-1",    "-1",    "-1",    "-1"],
            [    "-1",    "-1",    "-1",    "-1",    "-1",    "-1",    "-1",    "-1",    "-1",    "-1",   "-1",    "-1",    "-1",    "-1",    "-1",    "-1",    "-1",    "-1",    "-1",    "-1"],
            [    "-1",    "-1",    "-1",    "-1",    "-1",    "-1",    "-1",    "-1",    "-1",    "-1",   "-1",    "-1",    "-1",    "-1",    "-1",    "-1",    "-1",    "-1",    "-1",    "-1"]
        ]
    ]
}
